111111111111111111111111
100110000001100000011001
100100001100001100001001
100000000010010000000001
100000110010010011010001
100100000000100000000001
100110000110001000001001
110001000111111100101011
110001110000000010100001
100101000000000000100101
100100110000000010011001
110010010010010010010011
110010010010010010010011
100110110000000001011001
101100100000000100001001
100001100000000001101011
101101001110111100001001
100100000110001000011001
110000000000100000000001
100010110010010011010101
100000000010010000000001
100000000100001000101001
100110000100001000001001
111111111111111111111111
