1111111111
1000000001
1011100101
1000000101
1001000001
1001100101
1000000101
1011101101
1000000001
1111111111
