11111111111111111111
10000000000000000001
10011100111001111001
10001000000000000001
10001001110001111001
10001000000100001001
10000001100111100001
10111100000000000001
10001000101001010001
10001001111001011001
10000000010001001001
10101110000000000001
10101000100011011001
10001000100001010001
10000000000011000001
10100000111000000101
10100100001001000101
10001110000001100101
10000000000000000001
11111111111111111111
