11111111111111111111
10000000110001100001
10010100010101101001
10000000000100000001
10000001110001010001
10001000000110001001
10000001100110100001
10110010000000110001
10001000101000110101
10000010001001000001
10100000010000011101
10001111100011000001
10101000100011011001
10000000000000000011
10100010000100100101
10000100110001000001
10000100001101000101
11001110000000100001
11010010101100011011
11111111111111111111
