111111111111111111111111111111111111111111111111
100000001100011000100001100001100110001100000001
100101000101011010100001100001000100100000101001
100000000001000000001001100100000100110000000001
100000011100010100011000000110000010001110000001
110010000001100010000010010000011001100000010011
100000011001101000010001100010000100100110000001
101100100000001100011000000110000100000000001101
100010001010001101010000010010001100010110010001
100000100010010000010001100011000010010001000001
101000000100000111000010000000111000001000000101
100011111000110000000000000000000011000111110101
111010001000110110011000000110011111000100010101
100000000000000000100000000000000000000000000001
101000100001001001000001100000100100100001000101
100001001100010000000000010001000010001100100001
100001000011010001000100001000000010110000100001
110011100000001000000010000010100100000001110011
110100101011000110110011110010000000110101001011
100000001011000000100110011001010000110100000001
101001111000100110100100001001011001000111100101
100011100000000000110100001011000000000001110001
100000000010110000010100001010000011010000000001
100011011000000100000000000000001000000110110001
100011011000000100000000000000001000000110110001
100000000010110000010100001010000011010000000001
100011100000000000110100001011000000000001110001
101001111000100010000100001001000001000111100101
100000001011000010100110011001010000110100000001
110100101011000100010011110011001000110101001011
110011100000001101010010000000101100000001110011
100001000011010001000100000000000010110000100001
100001001100010000000000010000000010001100100001
101000100001001001000101001000100100100001000101
100000000000000000100000000001000000000000000001
111010001000111100011000000110011111000100010111
101011111000100100000000000000000011000111110101
101000000100000111000000010000011000001000000101
100000100010010000010001000010000010010001000001
100010001010001101010010010010101000010110010001
101100100000001100011000000110001110000000001101
100000011001101000010001100010000001100110000001
110010000001100010000010010000011001100000010011
100000011100010100011000000110001010001110000001
100010000001000000100001100001000000110000000001
100001000101011010000001100001000110110000101001
100000001100011000100001100001100110000100000001
111111111111111111111111111111111111111111111111
