111111111111111111111111111111111111111111111111111111111111111111111111111111111111111111111111
100000000100000000100110000001000001000000100000001001001000100000110010011000010000001000100001
100000000100001000100010110100001100001000000010000000000000001100000010010001000100101000000001
100100100010001010000000000010010001011111010000100110011110101000010000000000010100000000001001
100000000010010000000001110010000000011000010010010001000110000000110011100001100010110000100001
100100100000000000000100000000101000000000100000000101000000000100000000001000000000000001001001
101101110001010100100011011011101000000000001100001100100000000101110110110001000000100011001101
101100001001000011000000001010000111000000000000000000000000011000010100000001110100100100001001
100101000000011001000110000000100100001001010010011010100101001000000000011000000110000000101001
100100000000010000110010000011000001100010010000000010010001100010110000010011000010000000001001
100100000010000100000000001001000000010000110001100011000000100000100100000100001000010000001001
101110100000000101000011000001000000000010011111111110010000100000100010110000001000000001011101
100100110000000000010011000011000010011010000000000000010110000000100000110011000000010011001001
110000000100101101000011001001000011100011100001100001110001110000101100110000001101100000000001
100000100010000001100011011100001001100100001000000101001001100100001110110001000000000101000101
100100101010001010010010011100111000000001000100001000000000000111001110110011010100010101001001
100100101001110000000010000001001001000011010001100010010000110000100000000000000011100101001001
101110001001000010000001110101001101000000000000000000010000001100101011100000010000100100011101
100000000000000001100000000000011000001001001100001100100000000110000000010000100000000000000001
100111011001001100000100110110010001010000000000000000000000000010011011000000101100100110110001
100011000001100100001000000001100011000001101001100101100101110001100000000100001001000000100101
110000000100110100010001111001101011001001001010010100100100110101001111100010001011011000100001
110010001000010110010011001010001000010000000000000000000010000100000100110010011010000100010011
100000100000000000100001000000001000000001000100001000100000000100000000100001000010000101000001
100110011011101000000000101100010010101100110101100011001101010010001101000000000100100100011001
100000011000001001000010000010110110001100000101111000001100011010000000010000100100001110000001
101110000110100100100000100000100000110000001000000100000011000001100001001001001001011000011101
101110010100000000001110000110000000010000100001100001000010000000011000001100000000001000011101
100000000100010000111000100000100000001100000100001000001100000001000001000111000010001100000001
101000110010010011000000001100010001100011000100001000110001100010001100100100110010010011000101
100010100011011001011010000001000000111001000001100000100110010000100000000110100110110000010001
100000000000010001000000000111100000000101000001100000101000000001111000100000100010001010100001
110100001110000001001010100100010000000001010101100010100000000010001000010100100000001000001011
100011010010000000010000010000010100000001000000000100110000001010000010000010000000010010110001
100000000000000001010100000000010101001101110000000001001100101010000000001010100000000100000101
110010100100000000000101110001100000000100100000000001100000000001100011100000000000001001010001
111010000100111010000000000100100010000000100010000101000100011000001000000101010111000000010111
100010000000000011111100101100101000100111100110001001011001000000101101001100000000010100010011
100000100111100000000001100110000100110011000000100000010011001000101001100000000000110001000001
111001100100000110000100100001100100110000010111111010000010001001100000001000001010001001100101
100100100000001001000000000001000001000010000010010000010010100000110000000000101001000000010001
100010100100000000001010100000011001011100000000000001001110100110000001010000000000001001010101
100000100100000010010000010101000010010001000000000000000010010000100010001010010000001001000001
101001100000110110110100010001100000010000100101101001000010000001110110001011011011000001100101
100101000010000100010001000000000001011000010100001010000110100000000000100010001000010000101001
110000011010000100001100010011000010001000010100000010000100000000110100001100001000010110000011
100000100001100000101000000100110010001011100010010001110100110011000100010001000001100001000001
101010101000101010001010110100011100110000001000001100000011001110001001010110010101000101010101
101000101000101010011010100000011100100000001100001100001001001110001011010100010101000101010001
100100100001100000000010001000110011001011100010000001110000110011001000000101000001100001001001
110000010010000100001100011011000000001000010000001010000100000000100110001100011000000110000011
100101000110000101010001000000000001001000010100001010000110000000000000100010100000011000101001
101001100000110100010100010001100000110000000101101001000011000001110010001010001011000001100101
100000100100000010010000010101000010010001000000000000000010010000001010000010010000001001000001
100000100100000000001000000000011001011100100000000001001110100110000000010100000000001001010101
100110100000101101000000000010000001010010000010010000010010000000110000100000101000000001010001
101000100100000000000100100000100100010000010111101010000010001000100001001000001000001001000101
100000100011101001000001100100000001110011000000100000110011100000101001000000100101111001000001
110010000010000011111000101101101000100010100110011001011001000101001101001111110000000100010011
110011000100111000001000000100000110000000100010010001000000011001001000000000010111000000110111
110000100100000000000101110001100000000101100000000001101000000001100011101000000000001001000001
100000000000000001010100000000010101001101110000000001100100101010000000001010100000000000000101
100011000010000000010000010000010100000001000000000100110000001010000010000010000000010010110001
110100001110000001001010100100010000000001010101101000100000000010001001000100100000001000001011
100001000000010011000000000111100000000101000001100000101000000001111000100000100010101010100001
100010000011011001001010000001000010111001000001100000100111000000100000010110100110100000010001
101000100010010001001001001101000000100011000100001000110001100010001100000110010010000111000101
100000001100010000111000100000100000001100000100001000001100000001000001000111000010001000000001
101110000100000000001110000110000000010000100001100001000010000000001000011100000000001010011101
101110000110110100100000100000100000110000001000000100000011000001100001000001001001011000011101
100000011000000001000010000010110110001100000101101000001100010011000000010000000100000110010001
100110011011101000000000101100010000101100110101101011001101010010001101000001000100110100010001
100000001000000100100001000000001100000000000100001000100000001100000000100001000010000101000001
110010001000000100010001001000001000010010000000000000000010000100010000100010001010000100010011
100000000110011100010001111101101011001001001010010100100100110101000111000010001010011000000001
100011000001100000000000100001100011101001101001100101100100110001110001010100011001100000110001
110111011001001101010100100110010001000000000000000000000000100010011000000000100000100110110001
100000000000000101000010000000011000001000001100001100100100000110000010010001101000000000000101
101110001001010000000001110101001100000010000000000000000000101100101011000000000000100100011101
100100101001010000000000000001001001000011010001100010110000100100000000010000000001100101001001
100100101010000000110011011100011000000001000100001000000000000111001110110011010100010101001001
100000100000010001100011011101001001100000101000000101000001100100101110110001000000000101000101
110000000100100101000011001001000010100010100001100001110001110000101100110000101101100000000001
100100110010000000010011100001000010011110000000000000011110000000100001110010000000010011001001
101110100000000101000011000101000001000010010111111110010000100000101000110000101000000001011001
100000000010000100001000001001000001010000110000000011000010100001100100000100001000010000001001
101100000000010000010010000011010001000010010000010010000000000000110000010011000010000000001001
100000000000011001010110000000000100101000010110011010100101001000000000011010000110000000101001
101100101001000011000000001010000110000010000000000000000000111000010100000000010000100100001101
101100100001010000000011011011101000000001001100001100100000000101010110110001000010100011001101
100100000000000011000100000000001000000000100000000101000000000101000000001000100000000001001001
100001000011010001100001110011001000010000010010010001010111000000110011100000100000110000100001
100100100000000000000000000000010001001011011000000110010110001000000000000000000100010000001001
100000000111011000100010110100000100001000000010010000000000001100000011010001100110011000000001
100001000000000000100110000001000001000000100000000001001000100000110000011000000000000010000001
111111111111111111111111111111111111111111111111111111111111111111111111111111111111111111111111
