111111111111111111111111111111
100000000100000000100110000001
100000000100001000100010110101
100100100010001010000000000001
100000000010010000000001110001
100100100000000000000100000001
101101110001010100100011011001
101100001001000011000000001001
100101000000011001000110000001
100100000000010000110010000001
100100000010000100000000001001
101110100000000101000011000001
100100110000000000010011000001
110000000100101101000011001001
100000100010000001100011011101
100100101010001010010010011101
100100101001110000000010000001
101110001001000010000001110101
100000000000000001100000000001
100111011001001100000100110101
100011000001100100001000000001
110000000100110100010001111001
110010001000010110010011001001
100000100000000000100001000001
100110011011101000000000101101
100000011000001001000010000001
101110000110100100100000100001
101110010100000000001110000101
100000000100010000111000100001
111111111111111111111111111111
