111111111111111111111111111111
100000000000000000000000000001
100000100111110001111101111001
100100100010000000000000000001
100100100010010000100001110001
100100100000010000100100000001
100001110001010000100111011001
100000000001000011100000001001
100101100011010000000110001001
100100000110010001110010000001
100100100000000100000000001001
101110110011000100110001001001
100100000000000000010001000001
100000011100101101000000001001
100000000000100001100010001001
100100111000000011110010011101
100100101001111000000000000001
101110000001000010001100011101
100000000000000001100000000101
100111011001001100000100000101
100011000001100100001000000001
100000001000100100010001111001
100100011000100100100000010001
100100110000000000100000000001
100000000001101000000000111101
100100011000001000111100100001
101110000010111100100000100101
100100011110000000100110000101
100000000000000000000000000001
111111111111111111111111111111
